20
11
BBBBBBBBBBBBBBBBBBBB
B                  B
B                  B
B                  B
B      B B         B
B       H          B
B      B B         B
B                  B
B                  B
B                  B
BBBBBBBBBBBBBBBBBBBB